3,4
6
NONE,0,0,1,1,0
NONE,1,0,1,1,1
BLUE_AMMO,1,0,1,1,1
NONE,2,0,0,1,1
RED_AMMO,0,1,0,1,0
NONE,3,1,0,1,0
NONE,4,1,1,1,0
NONE,4,1,0,1,1
NONE,5,1,1,0,0
NONE,5,1,1,0,1
NONE,4,1,1,0,1
YELLOW_AMMO,4,1,0,0,1